1111111111111111111111111111111111
110000000000000C00000C000000000001
10000001000C0000101001000000010101
100E000000000010001001000000010101
100000000C00C000000000000C000000C1
10000001000000P0010000010000000001
100000000110C0000111000000011000C1
10000000000000000100E0000000C00001
100100000C0100000001001C0110000001
1000C0000110C000000000000010000001
1111111111111111111111111111111111