1111111111111111111111111111111111
1E0000000000000C00000C000000000001
10000001000C0000101001000000010101
100E000000000010001001000000010101
1P0000000C00C0000000000000000000C1
1P00000100000000000000010000000001
1P0000000110C0000000000000000000C1
1111111111111111111111111111111111
