11111111111111111
1C0000000000000C1
10111100100111101
10000101110100001
10010000000001001
10110110101101101
10000000100000001
11110101110101111
1111010CCC0101111
1E00000CCC00000E1
1111010CCC0101111
11110101110101111
10000000100000001
10110110101101101
10010000P00001001
10000101110100001
10111100100111101
1C0000000000000C1
11111111111111111
