1111111111111111111111111111111
1C0000000000000C10000C000000001
10001000C0011111000000E00011101
1000000000000010001000000000001
10000000000000000001100000000C1
1001111100000010000001110000001
1001000000011C10010100011110001
1001000000000010000000000C00001
10010000000100000001C0100010001
1000C000011C00P000000000001C001
1000010000000000100000001000001
1001000100000000101C00001011111
10000000E00000000010000010000C1
1111111111111111111111111111111
