11111111111
10000000001
10P010C0E01
10000000001
11111111111
