1111111111111
1E00000000001
1000000000001
100000P000001
1000000000001
10000000000C1
1111111111111
