11111111111111111
1E000000000000001
10010101010101001
10000000000000001
10010101010101001
10000000000000001
10010101010101001
10000000000000001
1P010101010101001
100000000000000C1
11111111111111111
