1111111111111111111111111111111111
1100P0000000000C00000C000000000001
10000001000C0000101001000E00010101
100E000000000010001001000000010101
100000000C00C000000000110C000000C1
10000001000000P0010000011110000001
100000000110C0000111000000111100C1
100000E0000000000100E0000000C10001
100100000C0100000001001C0110010001
1000C0000110C000000000000P10010001
1111111111111111111111111111111111
