1111111111111
100P000000001
10100E00C0001
1P00000000001
1111111111111
