11111
1C011
1E001
1P001
11111
